mild_climate =
{
	farm_rgo_size = 0.0
	farm_rgo_eff = 0.0
	mine_rgo_size = 0.0
	mine_rgo_eff = 0.0
}

temperate_climate =
{
	farm_rgo_size = 0.0
	farm_rgo_eff = 0.0
	mine_rgo_size = 0.0
	mine_rgo_eff = 0.0
}

harsh_climate =
{
	farm_rgo_size = 0.0
	farm_rgo_eff = 0.0
	mine_rgo_size = 0.0
	mine_rgo_eff = 0.0
	max_attrition = 5
}

inhospitable_climate =
{
	farm_rgo_size = 0.0
	farm_rgo_eff = 0.0
	mine_rgo_size = 0.0
	mine_rgo_eff = 0.0
	max_attrition = 10
}

mild_climate = {
	457 485 394 436 407 273 290 298 166 190 188 208 213 197 212 269 260 282 199 169 176 240 225 228 265 253 297 291 311 
	322 371 99 217 196 215 168 185 175 153 149 137 81 89 64 83 113 91 133 114 87 418 370 389 424 475 505 477 451 
	431 443 357 319 325 528 559 562 578 580 603 550 577 597 565 568 564 600 661 649 623 631 679 637 665 690 692 686 377 
	335 450 470 487 482 386 416 404 452 442 499 510 546 558 538 542 523 557 607 782 769 766 646 670 697 702 634 647 
	621 639 749 733 747 683 704 677 659 645 696 672 681 663 652 754 741 726 764 614 617 503 859 774 763 797 810 765 781 
	813 888 862 910 909 989 959 997 1028 828 812 830 833 849 863 848 898 819 807 841 876 896 916 928 872 912 939 937 1018 
	941 934 924 1053 
	395 356 403 391 441 498 533 620 638 699 
	839 829 820 840 846 822 808 773 743 836 835 
	12 2 
	353 590 481 	
}

temperate_climate = {
	79 58 72 47 28 39 29 26 54 71 59 63 110 115 97 121 105 132 139 126 143 161 148 157 146 136 135 
	142 158 167 183 184 198 192 165 179 141 138 120 86 186 195 180 160 106 288 275 285 321 334 419 430 519 575 468 
	561 511 534 507 449 437 458 585 531 480 768 753 695 712 662 656 701 619 708 755 716 759 675 715 727 752 694 666 
	650 719 720 691 707 669 655 355 354 376 359 369 516 270 259 247 283 268 294 306 284 305 257 237 249 262 281 267 
	245 254 280 293 296 279 231 219 226 214 238 243 256 242 266 244 323 326 271 300 272 301 194 200 178 159 140 104 
	129 123 145 150 223 209 234 251 241 236 255 289 274 172 177 189 156 218 230 211 191 235 229 252 202 35 75 43 
	74 103 116 95 117 76 92 70 78 67 109 128 94 144 130 134 155 154 44 60 55 31 34 42 38 51 45 41 
	393 410 380 362 387 396 339 368 345 340 315 327 473 469 484 440 489 428 408 444 448 429 483 466 456 435 409 417 
	358 337 385 373 384 366 344 331 304 310 320 309 302 303 314 330 328 308 351 338 350 374 343 336 364 381 378 361 
	392 375 413 383 401 423 379 522 494 476 540 514 518 478 551 547 490 525 465 493 472 492 602 710 729 744 706 
	738 737 728 685 689 724 756 767 775 757 750 780 783 794 791 770 798 527 544 515 526 521 566 586 495 563 584 
	588 574 548 601 587 629 625 668 651 541 560 569 700 609 618 657 628 688 598 654 581 313 316 341 349 372 382 398 
	460 426 439 433 438 447 427 412 414 432 425 455 461 479 504 535 529 471 506 500 363 352 517 497 488 491 530 537 
	513 512 543 556 567 501 582 608 633 594 611 653 635 615 644 664 640 632 613 680 660 642 698 684 682 742 722 748 
	674 622 612 869 804 824 779 803 880 858 947 962 946 935 895 891 976 1013 711 705 788 760 745 714 796 874 847 875 
	809 856 932 969 1001 1038 977 1004 965 996 980 1026 949 958 943 1003 964 963 995 1005 1006 1009 
	1014 1024 1049 1031 1027 1030 1037 1033 1047 1056 
	233 258 174 152 193 317 
	604 324 593 595 221 
}

harsh_climate = {
	10 68 118 65 107 124 82 96 360 453 402 332 520 459 717 778 792 761 204 163 224 295 292 147 
	171 222 201 347 406 434 342 299 312 318 415 462 399 464 641 624 667 596 630 616 671 605 579 776 687 421 422 529 571 
	539 553 583 589 572 552 718 723 648 658 709 735 627 867 816 795 771 758 818 844 815 837 879 904 832 884 925 968 960 
	950 940 930 971 952 911 920 921 931 906 918 923 915 929 900 905 917 901 908 890 893 886 881 961 978 982 993 736 731 
	730 772 789 838 805 790 751 800 825 693 732 713 784 951 889 799 787 885 871 933 823 854 850 785 814 919 
	897 894 914 936 927 873 870 845 882 902 967 954 957 974 948 981 1015 1054 1016 1045 1044 1008 
	955 1021 1012 985 994 973 975 953 1035 990 1040 1052 1042 1046 1048 1043 1057 
	1051 1058 1055 
	66 84 88 102 131 36 48 30 25 27 20 250 
	206 170 307 348 333 445 636 508 486 734 855 821 853 857 864 851 
	721 
	606 842 1041 
	33 365 591 
}

inhospitable_climate = {
	536 509 532 643 903 907 883 892 942 979 1020 
	678 945 801 802 811 992 1039 988 861 938 972 913 852 
	991 983 966 987 986 1002 998 1034 
	1017 1000 1010 1036 1007 1019 926 887 922 1011 956 
	944 1023 1029 1022 
	93 85 80 108 127 61 112 77 37 287 239 286 207 119 162 
	50 69 181 261 173 187 246 576 454 390 388 865 866 740 762 793 831 17 
	49 
	843 367 
	834 899 984 
	1059 1050 40 
}