europe = {
	provinces = {
		10 68 79 58 72 47 28 39 29 26 54 71 59 63 118 65 107 124 82 96 110 115 97 121 105 132 139 
126 143 161 148 157 146 136 135 142 158 167 183 184 198 192 165 179 141 138 120 86 186 195 180 160 106 360 453 
536 288 275 285 321 334 419 402 332 430 519 520 459 509 532 575 468 561 511 534 507 449 437 458 585 531 480 457 
485 717 778 643 792 768 753 761 695 712 662 656 701 619 708 755 716 759 675 715 727 752 694 666 650 719 720 691 
707 669 655 394 355 354 376 359 369 436 407 516 270 259 273 247 283 268 294 290 306 298 284 305 257 237 249 262 
281 267 245 254 280 293 296 279 231 219 226 214 238 243 256 242 266 244 323 326 271 300 272 301 194 200 178 159 
140 104 129 123 145 150 223 209 234 251 241 236 255 289 274 172 177 189 156 218 230 211 191 166 190 188 208 213 
197 235 229 212 269 252 260 282 202 199 204 169 176 163 240 225 228 224 295 292 265 253 297 291 311 322 371 35 
75 43 74 103 116 95 117 76 92 70 78 67 109 128 94 144 99 130 147 134 155 171 154 217 222 201 196 215 
168 185 175 153 149 137 81 89 64 83 113 91 133 114 87 44 60 55 31 34 42 38 51 45 41 393 410 418 
370 389 347 380 362 387 396 339 368 345 340 315 327 424 475 505 477 473 469 484 440 489 428 408 444 448 429 483 
466 456 435 409 417 358 337 385 373 384 366 344 331 304 310 320 309 302 303 314 330 328 308 351 338 350 374 343 
336 364 381 378 361 406 392 375 413 383 401 423 434 451 431 443 357 319 325 342 299 312 318 379 415 462 399 464 
522 494 476 540 514 518 478 551 547 490 525 465 493 472 492 528 559 562 578 580 603 641 624 550 577 597 565 568 
564 602 600 661 649 623 631 679 637 665 690 692 686 710 729 744 706 738 737 728 685 689 724 756 767 775 757 750 
780 791 770 798 527 544 515 526 521 566 586 495 563 584 588 574 548 601 587 629 625 668 651 541 560 569 700 609 
618 657 628 688 598 654 581 667 596 630 616 671 605 579 776 687 313 316 341 349 377 335 372 382 398 460 426 450 
439 470 421 422 487 482 386 416 404 433 438 447 427 412 414 432 425 452 442 455 461 479 499 510 546 504 558 535 
538 529 471 506 500 363 352 517 497 488 491 530 537 513 512 543 556 567 501 582 542 523 557 571 539 553 583 589 
572 552 608 633 594 611 653 635 615 607 621 639 704 677 659 645 696 672 681 663 652 622 614 617 612 627 503 711 
705 736 731 730 772 789 838 828 805 790 751 800 825 678 693 732 713 788 760 745 714 812 784 796 830 833 849 863 
848 898 874 819 807 841 847 875 876 896 916 928 872 912 939 937 801 802 811 861 938 889 913 809 852 799 787 885 
856 871 933 823 854 850 785 814 919 897 894 914 936 927 873 870 845 882 902 932 721 604 353 
367 324 481 365 591 221 606 842 590 593 595 834 899 40 
964 953 966 975 983 991 963 986 987 998 1002 1010 1000 1017 1035 1034 1036 794 783 766 782 748 742 722 682 
769 723 684 698 718 797 774 763 749 747 733 702 697 680 644 664 613 632 640 660 642 646 648 670 634 647 674 683 658 
709 735 764 726 741 754 945 988 951 972 957 974 954 992 1039 1045 1054 1059 1050 967 981 1015 
1016 1044 1001 1038 1008 1026 1041 1022 977 948 969 1004 980 1018 996 965 955 941 949 934 924 
958 943 973 1021 1012 985 994 1003 
	}
	assimilation_rate = -0.25
}

asia = {
	provinces = {
		867 859 869 810 816 795 771 758 818 804 824 765 779 803 781 844 815 813 837 879 880 904 858 832 947 884 925 968 960 
950 940 930 971 952 962 946 888 862 911 921 931 961 978 982 989 959 993 976 997 942 1028 1013 979 1020 
1007 990 995 1005 1019 1040 1052 1006 1009 1014 1024 1049 1031 1027 1042 
1046 1048 1043 1057 1030 1037 1033 1047 1056 1053 
926 887 922 1011 956 944 1051 1023 1029 1058 
1055 
984 
	}
	assimilation_rate = -0.5

}

africa = {
	provinces = {
920 910 935 906 918 923 909 915 929 900 905 917 903 907 901 908 895 891 890 893 886 
881 883 892 93 85 80 108 127 66 84 88 102 131 36 48 61 30 25 27 20 112 77 
37 233 258 250 206 174 152 193 170 307 317 287 239 286 207 119 162 50 69 181 261 173 
187 246 395 356 348 403 333 391 441 445 498 533 620 638 699 636 576 508 486 454 390 388 839 
829 820 840 846 822 808 773 743 734 865 866 740 762 793 831 836 835 821 853 857 
864 851 17 49 
12 2 843 33 
855 
	}
	assimilation_rate = -0.25

}
